Hīnc vĭă| Tārtărĕ|ī || quaē| fērt Ăchĕr|ōntĭs ăd| ūndās.295

tūrbĭdŭs| hīc caēn|ō || vās|tāquĕ vŏr|āgĭnĕ| gūrgĕs

aēstŭăt| ātque ōm|nēm || Cōc|Ŷto ēr|ūctăt hăr|ēnăm.

pōrtĭtŏr| hās hōr|rēndŭs || ă|quās ēt| flūmĭnă| sērvăt

tērrĭbĭl|ī squāl|ōrĕ || Chăr|ōn, cŭĭ| plūrĭmă| mēntō

cānĭtĭ|ēs īn|cūltă || iăc|ēt, stān|t lūmĭnă| flāmmā,300

sōrdĭdŭs| ēx ŭmĕr|īs || nōd|ō dēp|ēndĕt ăm|īctŭs.

īpsĕ răt|ēm cōn|tō || sŭbĭg|īt vēl|īsquĕ mĭn|īstrăt

ēt fēr|rūgĭnĕ|ā || sūb|vēctāt| cōrpŏră| cūmbā,

iām sĕnĭ|ōr, sēd| crūdă || dĕ|ō vĭrĭd|īsquĕ sĕn|ēctūs.

hūc ōm|nīs tūr|ba ād || rīp|ās ēf|fūsă rŭ|ēbăt,305

mātrēs| ātquĕ vĭr|ī || dēf|ūnctăquĕ| cōrpŏră| vītā

māgnănĭm|um hērō|ūm, || pŭĕr|i īnnūp|taēquĕ pŭ|ēllaē,

īmpŏsĭt|īquĕ rŏg|īs || iŭvĕn|ēs ān|te ōră păr|ēntŭm:

quām mūl|ta īn sīl|vīs || aūt|ūmnī| frīgŏrĕ| prīmō

lāpsă căd|ūnt fŏlĭ|a, aūt || ād| tērrām| gūrgĭte ăb| āltō310

quām mūl|taē glŏmĕr|āntŭr || ăv|ēs, ŭbĭ| frīgĭdŭs| ānnŭs

trāns pōn|tūm fŭgăt| ēt || tēr|rīs īm|mīttĭt ăp|rīcīs.

stābān|t ōrān|tēs || prīm|ī trān|smīttĕrĕ| cūrsŭm

tēndēb|āntquĕ măn|ūs || rīp|ae ūltĕrĭ|ōrĭs ăm|ōrĕ.

nāvĭtă| sēd trīs|tīs || nūn|c hōs nūn|c āccĭpĭt| īllōs,315

āst ălĭ|ōs lōn|gē || sūm|mōtōs| ārcĕt hăr|ēnā.

Aēnē|ās mīr|ātŭs || ĕn|īm mōt|ūsquĕ tŭm|ūltū

“dīc,” ăĭt|, “ō vīr|gō, || quīd| vūlt cōn|cūrsŭs ăd| āmnĕm?

quīdvĕ pĕt|ūnt ănĭm|aē? || vēl| quō dīs|crīmĭnĕ| rīpās

haē līn|quūnt, īl|laē || rēm|īs vădă| līvĭdă| vērrūnt?”320

ōllī| sīc brĕvĭt|ēr || fāt|a ēst lōn|gaēvă săc|ērdōs:

“Ānchīs|ā gĕnĕr|ātĕ, || dĕ|ūm cēr|tīssĭmă| prōlēs,

CōcŶt|ī stāg|na āltă || vĭd|ēs Stŷgĭ|āmquĕ păl|ūdĕm,

dī cŭĭ|ūs iūr|ārĕ || tĭm|ēnt ēt| fāllĕrĕ| nūmĕn.

haēc ōm|nīs, quām| cērnĭs, || ĭn|ōps ĭnhŭm|ātăquĕ| tūrba ēst;325

pōrtĭtŏr| īllĕ Chăr|ōn; || hī|, quōs vĕhĭt| ūndă, sĕp|ūltī.

nēc rīp|ās dătŭr| hōrrēn|dās || ēt| raūcă flŭ|ēntă

trānspōr|tārĕ prĭ|ūs || quām| sēdĭbŭs| ōssă quĭ|ērūnt.

cēntum ēr|rānt ān|nōs || vŏlĭt|āntque haēc| lītŏră| cīrcŭm;

tūm dēm|um ādmīs|sī || stāg|na ēxōp|tātă rĕv|īsūnt.”330

cōnstĭtĭt| Ānchīs|ā || sătŭs| ēt vēs|tīgĭă| prēssĭt

mūltă pŭt|āns sōr|tēmque || ănĭm|ō mĭsĕr|ātŭs ĭn|īquăm.

Ērgo ĭtĕr| īncēp|tūm || pĕrăg|ūnt flŭvĭ|ōquĕ prŏp|īnquānt.

nāvĭtă| quōs iam īn|de ūt || Stŷgĭ|ā prōs|pēxĭt ăb| ūndā385

pēr tăcĭt|ūm nĕmŭs| īrĕ || pĕd|ēmque ād|vērtĕrĕ| rīpaē,

sīc prĭŏr| ādgrĕdĭt|ūr || dīc|tīs āt|que īncrĕpăt| ūltrō:

“quīsquĭs ĕs|, ārmāt|ūs || quī| nōstra ād| flūmĭnă| tēndĭs,

fāre ăgĕ|, quīd vĕnĭ|ās, || iam īs|tīnc ēt| cōmprĭmĕ| grēssŭm.

ūmbrār|um hīc lŏcŭs| ēst, || sōm|nī nōc|tīsquĕ sŏp|ōraē:390

cōrpŏră| vīvă nĕf|ās || Stŷgĭ|ā vēc|tārĕ căr|īnā.

nēc vēr|o Ālcīd|ēn || mē| sūm laēt|ātŭs ĕ|ūntĕm

āccēp|īssĕ lăc|ū, || nēc| Thēsĕă| Pīrĭthŏ|ūmquĕ,

dīs quām|quām gĕnĭt|i ātque || īn|vīctī| vīrĭbŭs| ēssēnt.

Tārtărĕ|um īllĕ măn|ū || cūs|tōdem īn| vīnclă pĕt|īvĭt395

īpsĭŭs| ā sŏlĭ|ō || rēg|īs trāx|ītquĕ trĕm|ēntĕm;

hī dŏmĭn|ām Dīt|īs || thălăm|ō dēd|ūcĕre ăd|ōrtī.”

quaē cōn|trā brĕvĭt|ēr || fāt|a ēst Ām|phrŶsĭă| vātēs:

“nūllae hīc| īnsĭdĭ|aē || tāl|ēs (āb|sīstĕ mŏv|ērī),

nēc vīm| tēlă fĕr|ūnt; || lĭcĕt| īngēn|s iānĭtŏr| āntrō400

aētēr|nūm lāt|rāns || ēx|sānguēs| tērrĕăt| ūmbrās,

cāstă lĭc|ēt pătrŭ|ī || sēr|vēt Prōs|ērpĭnă| līmĕn.

Trōĭŭs| Aēnē|ās, || pĭĕt|āte īn|sīgnĭs ĕt| ārmīs,

ād gĕnĭt|ōrem īm|ās || Ĕrĕb|ī dēs|cēndĭt ăd| ūmbrās.

sī tē| nūllă mŏv|ēt || tān|taē pĭĕt|ātĭs ĭm|āgō,405

āt rām|um hūnc” (ăpĕr|īt || rām|ūm quī| vēstĕ lăt|ēbăt)

“āgnōs|cās.” tŭmĭd|a ēx || īr|ā tūm| cōrdă rĕs|īdūnt;

nēc plūr|a hīs. īl|le ādmīr|āns || vĕnĕr|ābĭlĕ| dōnŭm

fātāl|īs vīr|gaē || lōn|gō pōs|t tēmpŏrĕ| vīsŭm

caērŭlĕ|am ādvēr|tīt || pūp|pīm rīp|aēquĕ prŏp|īnquăt.410

īnde ălĭ|ās ănĭm|ās, || quaē| pēr iŭgă| lōngă sĕd|ēbānt,

dētūr|bāt lāx|ātquĕ || fŏr|ōs; sĭmŭl| āccĭpĭt| ālveō

īngēn|tem Aēnē|ān. || gĕmŭ|īt sūb| pōndĕrĕ| cūmbă

sūtĭlĭs| ēt mūl|tam āccēp|īt || rīm|ōsă păl|ūdĕm.

tāndēm| trāns flŭvĭ|um īncŏlŭm|ēs || vāt|ēmquĕ vĭr|ūmquĕ415

īnfōr|mī līm|ō || glaūc|āque ēx|pōnĭt ĭn| ūlvā.

Cērbĕrŭs| haēc īn|gēns || lāt|rātū| rēgnă trĭf|aūcī

pērsŏnăt| ādvēr|sō || rĕcŭb|āns īm|mānĭs ĭn| āntrō.

cuī vāt|ēs hōr|rērĕ || vĭd|ēns iām| cōllă cŏl|ūbrīs

mēllĕ sŏp|ōrāt|am ēt || mĕdĭc|ātīs| frūgĭbŭs| ōffăm420

ōbĭcĭt|. īllĕ făm|ē || răbĭd|ā trĭă| gūttŭră| pāndēns

cōrrĭpĭt| ōbiēc|tam, ātque || īm|mānĭă| tērgă rĕs|ōlvĭt

fūsŭs hŭm|ī tōt|ōque || īn|gēns ēx|tēndĭtŭr| āntrō.

ōccŭpăt| Aēnē|ās || ădĭt|ūm cūs|tōdĕ sĕp|ūltō

ēvād|ītquĕ cĕl|ēr || rīp|am īnrĕmĕ|ābĭlĭs| ūndaē.425

īntēr| quās Phoēn|īssă || rĕc|ēns ā| vūlnĕrĕ| Dīdō450

ērrāb|āt sīl|va īn || māg|nā; quām| Trōĭŭs| hērōs

ūt prīm|ūm iūx|tā || stĕtĭt| āgnōv|ītquĕ pĕr| ūmbrās

ōbscūr|ām, quāl|ēm || prīm|ō quī| sūrgĕrĕ| mēnsĕ

aūt vĭdĕt| aūt vīd|īssĕ || pŭt|āt pēr| nūbĭlă| lūnăm,

dēmīs|īt lăcrĭm|ās || dūl|cīque ād|fātŭs ăm|ōre ēst:455

“īnfēl|īx Dīd|ō, || vēr|ūs mĭhĭ| nūntĭŭs| ērgō

vēnĕrăt| ēxstīn|ctām || fēr|rōque ēx|trēmă sĕc|ūtăm?

fūnĕrĭs| heū tĭbĭ| caūsă || fŭ|ī? pēr| sīdĕră| iūrō,

pēr sŭpĕr|ōs ēt| sī || quă fĭd|ēs tēl|lūrĕ sŭb| īma ēst,

īnvīt|ūs, rēg|īnă, || tŭ|ō dē| lītŏrĕ| cēssī.460

sēd mē| iūssă dĕ|ūm, || quaē| nūnc hās| īrĕ pĕr| ūmbrās,

pēr lŏcă| sēntă sĭt|ū || cōg|ūnt nōc|tēmquĕ prŏf|ūndăm,

īmpĕrĭ|īs ēg|ērĕ || sŭ|īs; nēc| crēdĕrĕ| quīvī

hūnc tān|tūm tĭbĭ| mē || dīs|cēssū| fērrĕ dŏl|ōrĕm.

sīstĕ grăd|ūm tē|que āspēc|tū || nē| sūbtrăhĕ| nōstrō.465

quēm fŭgĭs|? ēxtrēm|ūm || fāt|ō quōd| te ādlŏquŏr| hōc ēst.”

tālĭbŭs| Aēnē|ās || ār|dēntem ēt| tōrvă tŭ|ēntĕm

lēnīb|āt dīc|tīs || ănĭm|ūm lăcrĭm|āsquĕ cĭ|ēbăt.

īllă sŏl|ō fīx|ōs || ŏcŭl|ōs āv|ērsă tĕn|ēbăt

nēc măgĭs| īncēp|tō || vūl|tūm sēr|mōnĕ mŏv|ētŭr470

quām sī| dūră sĭl|ēx || aūt| stēt Mār|pēsĭă| caūtēs.

tāndēm| cōrrĭpŭ|īt || sēs|e ātque ĭnĭm|īcă rĕf|ūgĭt

īn nĕmŭs| ūmbrĭfĕr|ūm, || cōn|iūnx ŭbĭ| prīstĭnŭs| īllī

rēspōn|dēt cūr|īs || aē|quātquĕ Sŷc|haēŭs ăm|ōrĕm.

nēc mĭnŭs| Aēnē|ās || cās|ū pēr|cūssŭs ĭn|īquō475

prōsĕquĭt|ūr lăcrĭm|īs || lōn|ge ēt mĭsĕr|ātŭr ĕ|ūntĕm.

“ēxcūd|ēnt ălĭ|ī || spīr|āntĭă| mōllĭŭs| aēră

(crēdo ĕquĭd|ēm), vīv|ōs || dūc|ēnt dē| mārmŏrĕ| vūltūs,

ōrāb|ūnt caūs|ās || mĕlĭ|ūs, caēl|īquĕ mĕ|ātūs

dēscrīb|ēnt rădĭ|o ēt || sūr|gēntĭă| sīdĕră| dīcēnt:850

tū rĕgĕr|e īmpĕrĭ|ō || pŏpŭl|ōs, Rōm|ānĕ, mĕm|ēntō

(haē tĭbi ĕr|ūnt ār|tēs), || pāc|īque īm|pōnĕrĕ| mōrĕm,

pārcĕrĕ| sūbiēc|tīs || ēt| dēbēl|lārĕ sŭp|ērbōs.”

Sīc pătĕr| Ānchīs|ēs, || āt|que haēc mīr|āntĭbŭs| āddĭt:

“āspĭce, ŭt| īnsīg|nīs || spŏlĭ|īs Mār|cēllŭs ŏp|īmīs855

īngrĕdĭt|ūr vīc|tōrquĕ || vĭr|ōs sŭpĕr|ēmĭnĕt| ōmnēs.

hīc rēm| Rōmān|ām || māg|nō tūr|bāntĕ tŭm|ūltū

sīstĕt ĕ|quēs, stēr|nēt || Poēn|ōs Gāl|lūmquĕ rĕb|ēllĕm,

tērtĭă|que ārmă păt|rī || sūs|pēndēt| cāptă Quĭr|īnō.”

ātque hīc| Aēnē|ās || (ūn|ā nām|que īrĕ vĭd|ēbăt860

ēgrĕgĭ|ūm fōr|mā || iŭvĕn|em ēt fūl|gēntĭbŭs| ārmīs,

sēd frōn|s laētă păr|um ēt || dē|iēctō| lūmĭnă| vūltū)

“quīs, pătĕr|, īllĕ, vĭr|ūm || quī| sīc cŏmĭt|ātŭr ĕ|ūntĕm?

fīlĭŭs|, ānne ălĭ|quīs || māg|nā dē| stīrpĕ nĕp|ōtŭm?

quī strĕpĭt|ūs cīr|cā || cŏmĭt|ūm! quān|tum īnstăr ĭn| īpsō!865

sēd nōx| ātră căp|ūt || trīs|tī cīr|cūmvŏlăt| ūmbrā.”

tūm pătĕr| Ānchīs|ēs || lăcrĭm|īs īn|grēssŭs ŏb|ōrtīs:

“ō gnāt|e, īngēn|tēm || lūc|tūm nē| quaērĕ tŭ|ōrŭm;

ōstēn|dēnt tēr|rīs || hūn|c tāntūm| fātă nĕc| ūltrā

ēssĕ sĭn|ēnt. nĭmĭ|ūm || vōb|īs Rōm|ānă prŏp|āgō870

vīsă pŏt|ēns, sŭpĕr|ī, || prŏprĭ|a haēc sī| dōnă fŭ|īssēnt.

quāntōs| īllĕ vĭr|ūm || māg|nām Māv|ōrtĭs ăd| ūrbĕm

cāmpŭs ăg|ēt gĕmĭt|ūs! || vēl| quaē, Tĭbĕr|īnĕ, vĭd|ēbĭs

fūnĕră|, cūm tŭmŭl|ūm || praēt|ērlāb|ērĕ rĕc|ēntĕm!

nēc pŭĕr| Īlĭăc|ā || quīs|quām dē| gēntĕ Lăt|īnōs875

īn tān|tūm spē| tōllĕt || ăv|ōs, nēc| Rōmŭlă| quōndăm

ūllō| sē tān|tūm || tēl|lūs iāc|tābĭt ăl|ūmnō.

heū pĭĕt|ās, heū| prīscă || fĭd|ēs īn|vīctăquĕ| bēllō

dēxtĕră|! nōn īl|lī || sē| quīsquam īm|pūnĕ tŭl|īssĕt

ōbvĭŭs| ārmāt|ō, || seū| cūm pĕdĕs| īrĕt ĭn| hōstĕm880

seū spūm|āntĭs ĕ|quī || fŏdĕr|ēt cāl|cārĭbŭs| ārmōs.

heū, mĭsĕr|āndĕ pŭ|ēr, || sī| quā fāt|a āspĕră| rūmpās,

tū Mār|cēllŭs ĕr|īs. || mănĭb|ūs dătĕ| līlĭă| plēnīs

pūrpŭrĕ|ōs spār|gām || flōr|ēs ănĭm|āmquĕ nĕp|ōtĭs

hīs sāl|tem āccŭmŭl|ēm || dōn|īs, ēt| fūngăr ĭn|ānī885

mūnĕrĕ|.” sīc tōt|ā || pās|sīm rĕgĭ|ōnĕ văg|āntŭr

āĕrĭs| īn cām|pīs || lāt|īs āt|que ōmnĭă| lūstrānt.

quaē pōs|tquam Ānchīs|ēs || nāt|ūm pēr| sīngŭlă| dūxĭt

īncēn|dītque ănĭm|ūm || fām|aē vĕnĭ|ēntĭs ăm|ōrĕ,

ēxīm| bēllă vĭr|ō || mĕmŏr|āt quaē| deīndĕ gĕr|ēndă,890

Laūrēn|tēsquĕ dŏc|ēt || pŏpŭl|ōs ūr|bēmquĕ Lăt|īnī,

ēt quō| quēmquĕ mŏd|ō || fŭgĭ|ātquĕ fĕr|ātquĕ lăb|ōrĕm.

Sūnt gĕmĭn|aē Sōm|nī || pōr|taē, quār|um āltĕră| fērtŭr

cōrnĕă|, quā vēr|īs || făcĭl|īs dătŭr| ēxĭtŭs| ūmbrīs,

āltĕră| cāndēn|tī || pēr|fēctă nĭt|ēns ĕlĕp|hāntō,895

sēd fāl|sa ād caēl|ūm || mīt|tūnt īn|sōmnĭă| Mānēs.

hīs ĭbĭ| tūm nāt|um Ānchīs|ēs || ūn|āquĕ Sĭb|Ŷllăm

prōsĕquĭt|ūr dīc|tīs || pōr|tāque ēm|īttĭt ĕb|ūrnā,

īllĕ vĭ|ām sĕcăt| ād || nāv|ēs sŏcĭ|ōsquĕ rĕv|īsĭt.

Ārmă vĭr|ūmquĕ căn|ō, || Trō|iaē quī| prīmŭs ăb| ōrīs

Ītălĭ|ām fāt|ō || prŏfŭg|ūs Lāv|īniăquĕ| vēnĭt

lītŏră|, mūltum īl|le ēt || tēr|rīs iāc|tātŭs ĕt| āltō

vī sŭpĕr|ūm, saēv|aē || mĕmŏr|ēm Iūn|ōnĭs ŏb| īrăm,

mūltă quŏ|que ēt bēl|lō || pās|sūs, dūm| cōndĕrĕt| ūrbĕm5

īnfēr|rētquĕ dĕ|ōs || Lătĭ|ō; gĕnŭs| ūndĕ Lăt|īnŭm

Ālbān|īquĕ păt|rēs || āt|que āltaē| moēnĭă| Rōmaē.

Mūsă, mĭh|ī caūs|ās || mĕmŏr|ā, quō| nūmĭnĕ| laēsō

quīdvĕ dŏl|ēns rēg|īnă || dĕ|ūm tōt| vōlvĕrĕ| cāsūs

īnsīg|nēm pĭĕt|ātĕ || vĭr|ūm, tŏt ăd|īrĕ lăb|ōrēs10

īmpŭlĕr|īt. tān|taēne || ănĭm|īs caēl|ēstĭbŭs| īraē?

Ūrbs ān|tīquă fŭ|īt || (Tŷrĭ|ī tĕnŭ|ērĕ cŏl|ōnī)

Kārthāg|o, Ītălĭ|ām || cōn|trā Tĭbĕr|īnăquĕ| lōngē

ōstĭă|, dīvĕs ŏp|ūm || stŭdĭ|īsque ās|pērrĭmă| bēllī,

quām Iūn|ō fēr|tūr || tēr|rīs măgĭs| ōmnĭbŭs| ūnăm15

pōsthăbĭt|ā cŏlŭ|īssĕ || Săm|ō. hīc| īllĭŭs| ārmă,

hīc cūr|rūs fŭĭt|; hōc || rēg|nūm dĕă| gēntĭbŭs| ēssĕ,

sī quā| fātă sĭn|ānt, || iām| tūm tēn|dītquĕ fŏv|ētquĕ.

prōgĕnĭ|ēm sĕd ĕn|īm || Trō|iāno ā| sānguĭnĕ| dūcī

aūdĭĕr|āt Tŷrĭ|ās || ōl|īm quaē| vērtĕrĕt| ārcēs;20

hīnc pŏpŭl|ūm lāt|ē || rēg|ēm bēl|lōquĕ sŭp|ērbŭm

vēntūr|um ēxcĭdĭ|ō || Lĭbŷ|aē; sīc| vōlvĕrĕ| Pārcās.

īd mĕtŭ|ēns vĕtĕr|īsquĕ || mĕm|ōr Sāt|ūrnĭă| bēllī,

prīmă quŏd| ād Trō|iām || prō| cārīs| gēssĕrăt| Ārgīs—

nēcdum ĕtĭ|ām caūs|ae īrār|ūm || saēv|īquĕ dŏl|ōrēs25

ēxcĭdĕr|ānt ănĭm|ō; || mănĕt| āltā| mēntĕ rĕp|ōstŭm

iūdĭcĭ|ūm Părĭd|īs || sprēt|aēque īn|iūrĭă| fōrmaē

ēt gĕnŭs| īnvīs|um ēt || rāp|tī Gănŷm|ēdĭs hŏn|ōrēs:

hīs āc|cēnsă sŭp|ēr || iāc|tātōs| aēquŏrĕ| tōtō

Trōās|, rēlĭquĭ|ās || Dănă|um ātque īm|mītĭs Ăc|hīllī,30

ārcēb|āt lōn|gē || Lătĭ|ō, mūl|tōsquĕ pĕr| ānnōs

ērrāb|ānt āc|tī || fāt|īs mărĭ|a ōmnĭă| cīrcŭm.

tāntaē| mōlĭs ĕr|āt || Rōm|ānām| cōndĕrĕ| gēntĕm.

Vīx ē| cōnspēc|tū || Sĭcŭl|aē tēl|lūrĭs ĭn| āltŭm

vēlă dăb|ānt laēt|i ēt || spūm|ās sălĭs| aērĕ rŭ|ēbānt,35

cūm Iūn|o aētēr|nūm || sēr|vāns sūb| pēctŏrĕ| vūlnŭs

haēc sēc|ūm: “mēn|e īncēp|tō || dēs|īstĕrĕ| vīctăm

nēc pōs|se Ītălĭ|ā || Teūc|rōrum āv|ērtĕrĕ| rēgĕm!

quīppĕ vĕt|ōr fāt|īs. || Pāl|lāsne ēx|ūrĕrĕ| clāssĕm

Ārgīv|um ātque īp|sōs || pŏtŭ|īt sūm|mērgĕrĕ| pōntō40

ūnĭŭs| ōb nōx|am ēt || fŭrĭ|ās Ā|iācĭs Ŏ|īleī?

īpsă Iŏv|īs răpĭd|ūm || iăcŭl|āta ē| nūbĭbŭs| īgnĕm

dīsiēc|ītquĕ răt|ēs || ēv|ērtīt|que aēquŏră| vēntīs,

īllum ēx|spīrān|tēm || trān|sfīxō| pēctŏrĕ| flāmmās

tūrbĭnĕ| cōrrĭpŭ|īt || scŏpŭl|ōque īn|fīxĭt ăc|ūtō;45

āst ĕgŏ|, quaē dīv|um īncēd|ō || rēg|īnă Iŏv|īsquĕ

ēt sŏrŏr| ēt cōn|iūnx, || ūn|ā cūm| gēntĕ tŏt| ānnōs

bēllă gĕr|o. ēt quīs|quām || nūm|ēn Iūn|ōnĭs ăd|ōrăt

praētĕrĕ|a aūt sūp|plēx || ār|īs īm|pōnĕt hŏn|ōrĕm?”

Tālĭă| flāmmāt|ō || sēc|ūm dĕă| cōrdĕ vŏl|ūtāns50

nīmbōr|um īn pătrĭ|ām, || lŏcă| fētă fŭr|ēntĭbŭs| Aūstrīs,

Aēŏlĭ|ām vĕnĭt|. hīc || vās|tō rēx| Aēŏlŭs| āntrō

lūctān|tēs vēn|tōs || tēm|pēstāt|ēsquĕ sŏn|ōrās

īmpĕrĭ|ō prĕmĭt| āc || vīn|clīs ēt| cārcĕrĕ| frēnăt.

īlli īn|dīgnān|tēs || māg|nō cūm| mūrmŭrĕ| mōntĭs55

cīrcūm| claūstră frĕm|ūnt; || cēl|sā sĕdĕt| Aēŏlŭs| ārcĕ

scēptră tĕn|ēns mōl|lītque || ănĭm|ōs ēt| tēmpĕrăt| īrās.

nī făcĭ|āt, mărĭ|a āc || tēr|rās caēl|ūmquĕ prŏf|ūndŭm

quīppĕ fĕr|ānt răpĭd|ī || sēc|ūm vēr|rāntquĕ pĕr| aūrās;

sēd pătĕr| ōmnĭpŏt|ēns || spēl|ūncīs| ābdĭdĭt| ātrīs60

hōc mĕtŭ|ēns mōl|ēmque || ēt| mōntēs| īnsŭpĕr| āltōs

īmpŏsŭ|īt, rēg|ēmquĕ || dĕd|īt quī| foēdĕrĕ| cērtō

ēt prĕmĕr|e ēt lāx|ās || scīr|ēt dărĕ| iūssŭs hăb|ēnās.

ād quēm| tūm Iūn|ō || sūp|plēx hīs| vōcĭbŭs| ūsa ēst:

“Aēŏlĕ| (nāmquĕ tĭb|ī || dīv|ūm pătĕr| ātque hŏmĭn|ūm rēx65

ēt mūl|cērĕ dĕd|īt || flūc|tūs ēt| tōllĕrĕ| vēntō),

gēns ĭnĭm|īcă mĭh|ī || TŶr|rhēnūm| nāvĭgăt| aēquŏr

Īlĭum ĭn| Ītălĭ|ām || pōr|tāns vīc|tōsquĕ pĕn|ātēs:

īncŭtĕ| vīm vēn|tīs || sūb|mērsās|que ōbrŭĕ| pūppēs,

aūt ăgĕ| dīvēr|sōs || ēt| dīssĭcĕ| cōrpŏră| pōntō.70

sūnt mĭhĭ| bīs sēp|tēm || praēs|tāntī| cōrpŏrĕ| NŶmphaē,

quārūm| quaē fōr|mā || pūl|chērrĭmă| Dēĭŏp|ēă,

cōnūb|iō iūn|gām || stăbĭl|ī prŏprĭ|āmquĕ dĭc|ābō,

ōmnēs| ūt tēc|ūm || mĕrĭt|īs prō| tālĭbŭs| ānnōs

ēxĭgăt| ēt pūl|chrā || făcĭ|āt tē| prōlĕ păr|ēntĕm.”75

Aēŏlŭs| haēc cōn|trā: || “tŭŭs|, ō rēg|īnă, quĭd| ōptēs

ēxplōr|ārĕ lăb|ōr; || mĭhĭ| iūssă căp|ēssĕrĕ| fās ēst.

tū mĭhĭ| quōdcūm|que hōc || rēg|nī, tū| scēptră Iŏv|ēmquĕ

cōncĭlĭ|ās, tū| dās || ĕpŭl|īs āc|cūmbĕrĕ| dīvŭm

nīmbōr|ūmquĕ făc|īs || tēm|pēstāt|ūmquĕ pŏt|ēntĕm.”80

Haēc ŭbĭ| dīctă, căv|ūm || cōn|vērsā| cūspĭdĕ| mōntĕm

īmpŭlĭt| īn lătŭs|; āc || vēn|tī vĕlŭt| āgmĭnĕ| fāctō,

quā dătă| pōrtă, rŭ|ūnt || ēt| tērrās| tūrbĭnĕ| pērflānt.

īncŭbŭ|ērĕ măr|ī || tōt|ūmque ā| sēdĭbŭs| īmīs

ūna Eūr|ūsquĕ Nŏt|ūsquĕ || rŭ|ūnt crēb|ērquĕ prŏc|ēllīs85

Āfrĭcŭs|, ēt vās|tōs || vōl|vūnt ād| lītŏră| flūctūs.

īnsĕquĭt|ūr clām|ōrquĕ || vĭr|ūm strīd|ōrquĕ rŭd|ēntŭm;

ērĭpĭ|ūnt sŭbĭt|ō || nūb|ēs caēl|ūmquĕ dĭ|ēmquĕ

Teūcrōr|um ēx ŏcŭl|īs; || pōn|tō nōx| īncŭbăt| ātră;

īntŏnŭ|ērĕ pŏl|i ēt || crēb|rīs mĭcăt| īgnĭbŭs| aēthēr90

praēsēn|tēmquĕ vĭr|īs || īn|tēntān|t ōmnĭă| mōrtĕm.

ēxtēm|plo Aēnē|aē || sōl|vūntūr| frīgŏrĕ| mēmbră;

īngĕmĭt| ēt dŭplĭc|ēs || tēn|dēns ād| sīdĕră| pālmās

tālĭă| vōcĕ rĕf|ērt: || “ō| tērquĕ quăt|ērquĕ bĕ|ātī,

quīs ān|te ōră păt|rūm || Trō|iaē sūb| moēnĭbŭs| āltīs95

cōntĭgĭt| ōppĕtĕr|e! ō || Dănă|ūm fōr|tīssĭmĕ| gēntĭs

TŶdīd|ē! mēn|e Īlĭăc|īs || ōc|cūmbĕrĕ| cāmpīs

nōn pŏtŭ|īssĕ tŭ|āque || ănĭm|am hānc ēf|fūndĕrĕ| dēxtrā,

saēvŭs ŭb|i Aēăcĭd|aē || tēl|ō iăcĕt| Hēctŏr, ŭb|i īngēns

Sārpēd|ōn, ŭbĭ| tōt || Sĭmŏ|īs cōr|rēptă sŭb| ūndīs100

scūtă vĭr|ūm gălĕ|āsque || ēt| fōrtĭă| cōrpŏră| vōlvĭt!”

Tālĭă| iāctān|tī || strīd|ēns Ăquĭl|ōnĕ prŏc|ēllă

vēlum ād|vērsă fĕr|īt, || flūc|tūsque ād| sīdĕră| tōllĭt.

frāngūn|tūr rēm|ī, || tūm| prōra āv|ērtĭt ĕt| ūndīs

dāt lătŭs|, īnsĕquĭt|ūr || cŭmŭl|ō praēr|ūptŭs ă|quaē mōns.105

hī sūm|mo īn flūc|tū || pēn|dēnt; hīs| ūndă dĕh|īscēns

tērram īn|tēr flūc|tūs || ăpĕr|īt, fŭrĭt| aēstŭs hăr|ēnīs.

Trēs Nŏtŭs| ābrēp|tās || īn| sāxă lăt|ēntĭă| tōrquĕt

(sāxă vŏc|ānt Ĭtăl|ī || mĕdĭ|īs quae īn| flūctĭbŭs| Ārās,

dōrsum īm|mānĕ măr|ī || sūm|mō), trēs| Eūrŭs ăb| āltō110

īn brĕvĭ|a ēt sŶr|tēs || ūr|gēt, mĭsĕr|ābĭlĕ| vīsū,

īnlīd|ītquĕ văd|īs || āt|que āggĕrĕ| cīngĭt hăr|ēnaē.

ūnām|, quaē Lŷcĭ|ōs || fīd|ūmquĕ vĕh|ēbăt Ŏr|ōntēn,

īpsĭŭs| ānte ŏcŭl|ōs || īn|gēns ā| vērtĭcĕ| pōntŭs

īn pūp|pīm fĕrĭt|: ēxcŭtĭt|ūr || prōn|ūsquĕ măg|īstĕr115

vōlvĭtŭr| īn căpŭt|, āst || īl|lām tēr| flūctŭs ĭb|īdĕm

tōrquĕt ăg|ēns cīr|cum ēt || răpĭd|ūs vŏrăt| aēquŏrĕ| vērtēx.

āppār|ēnt rār|ī || nān|tēs īn| gūrgĭtĕ| vāstō,

ārmă vĭr|ūm tăbŭl|aēque || ēt| Trōĭă| gāză pĕr| ūndās.

iām vălĭd|am Īlĭŏn|eī || nāv|ēm, iām| fōrtĭs Ăc|hātaē,120

ēt quā| vēctŭs Ăb|ās, || ēt| quā grān|daēvŭs Ăl|ētēs,

vīcĭt hĭ|ēms; lāx|īs || lătĕr|ūm cōm|pāgĭbŭs| ōmnēs

āccĭpĭ|ūnt ĭnĭm|īcum || īm|brēm rīm|īsquĕ făt|īscūnt.

Īntĕrĕ|ā māg|nō || mīs|cērī| mūrmŭrĕ| pōntŭm

ēmīs|sāmque hĭĕm|ēm || sēn|sīt Nēp|tūnŭs ĕt| īmīs125

stāgnă rĕf|ūsă văd|īs, || grăvĭt|ēr cōm|mōtŭs, ĕt| āltō

prōspĭcĭ|ēns sūm|mā || plăcĭd|ūm căpŭt| ēxtŭlĭt| ūndā.

dīsiēc|tam Aēnē|aē || tōt|ō vĭdĕt| aēquŏrĕ| clāssĕm,

flūctĭbŭs| ōpprēs|sōs || Trō|ās caēl|īquĕ rŭ|īnā;

nēc lătŭ|ērĕ dŏl|ī || frāt|rēm Iūn|ōnĭs ĕt| īraē.130

Eūrum ād| sē Zĕphŷr|ūmquĕ || vŏc|āt, deīn|c tālĭă| fātŭr:

“Tāntănĕ| vōs gĕnĕr|īs || tĕnŭ|īt fīd|ūcĭă| vēstrī?

iām caēl|ūm tēr|rāmquĕ || mĕ|ō sĭnĕ| nūmĭnĕ|, vēntī,

mīscēr|e ēt tān|tās || aūd|ētīs| tōllĕrĕ| mōlēs?

quōs ĕgŏ|—sēd mōt|ōs || praēs|tāt cōm|pōnĕrĕ| flūctūs.135

pōst mĭhĭ| nōn sĭmĭl|ī || poēn|ā cōm|mīssă lŭ|ētĭs.

mātūr|ātĕ fŭg|ām || rēg|īque haēc| dīcĭtĕ| vēstrō:

nōn īl|li īmpĕrĭ|ūm || pĕlăg|ī saēv|ūmquĕ trĭd|ēntĕm,

sēd mĭhĭ| sōrtĕ dăt|ūm. || tĕnĕt| īlle īm|mānĭă| sāxă,

vēstrās|, Eūrĕ, dŏm|ōs; || īl|lā sē| iāctĕt ĭn| aūlā140

Aēŏlŭs| ēt claūs|ō || vēn|tōrūm| cārcĕrĕ| rēgnĕt.”

Sīc ăĭt|, ēt dīc|tō || cĭtĭ|ūs tŭmĭd|a aēquŏră| plācăt

cōllēc|tāsquĕ fŭg|āt || nūb|ēs sōl|ēmquĕ rĕd|ūcĭt.

CŶmŏthŏ|ē sĭmŭl| ēt || Trīt|ōn ād|nīxŭs ăc|ūtō

dētrūd|ūnt nāv|ēs || scŏpŭl|ō; lĕvăt| īpsĕ trĭd|ēntī145

ēt vās|tās ăpĕr|īt || sŶr|tēs ēt| tēmpĕrăt| aēquŏr

ātquĕ rŏt|īs sūm|mās || lĕvĭb|ūs pēr|lābĭtŭr| ūndās.

āc vĕlŭt|ī māg|no īn || pŏpŭl|ō cūm| saēpĕ cŏ|ōrta ēst

sēdĭtĭ|ō saēv|ītque || ănĭm|īs īg|nōbĭlĕ| vūlgŭs

iāmquĕ făc|ēs ēt| sāxă || vŏl|ānt, fŭrŏr| ārmă mĭn|īstrăt;150

tūm, pĭĕt|ātĕ grăv|em āc || mĕrĭt|īs sī| fōrtĕ vĭr|ūm quĕm

cōnspēx|ērĕ, sĭl|ēnt || ār|rēctīs|que aūrĭbŭs| āstānt;

īllĕ rĕg|īt dīc|tīs || ănĭm|ōs ēt| pēctŏră| mūlcĕt:

sīc cūn|ctūs pĕlăg|ī || cĕcĭd|īt frăgŏr|, aēquŏră| pōstquăm

prōspĭcĭ|ēns gĕnĭt|ōr || caēl|ōque īn|vēctŭs ăp|ērtō155

flēctĭt ĕ|quōs cūr|rūquĕ || vŏl|āns dāt| lōră sĕc|ūndō.

Dēfēs|si Aēnĕăd|aē || quaē| prōxĭmă| lītŏră| cūrsū

cōntēn|dūnt pĕtĕr|e, ēt || Lĭbŷ|aē vēr|tūntŭr ăd| ōrās.

ēst īn| sēcēs|sū || lōn|gō lŏcŭs|: īnsŭlă| pōrtŭm

ēffĭcĭt| ōbiēc|tū || lătĕr|ūm, quĭbŭs| ōmnĭs ăb| āltō160

frāngĭtŭr| īnquĕ sĭn|ūs || scīn|dīt sēs|e ūndă rĕd|ūctōs.

hīnc āt|que hīnc vās|taē || rūp|ēs gĕmĭn|īquĕ mĭn|āntŭr

īn caēl|ūm scŏpŭl|ī, || quōr|ūm sūb| vērtĭcĕ| lātē

aēquŏră| tūtă sĭl|ēnt; || tūm| sīlvīs| scaēnă cŏr|ūscīs

dēsŭpĕr|, hōrrēn|tīque || āt|rūm nĕmŭs| īmmĭnĕt| ūmbrā.165

frōntĕ sŭb| ādvēr|sā || scŏpŭl|īs pēn|dēntĭbŭs| āntrŭm;

īntŭs ă|quaē dūl|cēs || vīv|ōquĕ sĕd|īlĭă| sāxō,

NŶmphār|ūm dŏmŭs|. hīc || fēs|sās nōn| vīncŭlă| nāvēs

ūllă tĕn|ēnt, ūn|cō || nōn| āllĭgăt| āncŏră| mōrsū.

hūc sēp|tem Aēnē|ās || cōl|lēctīs| nāvĭbŭs| ōmnī170

ēx nŭmĕr|ō sŭbĭt|, āc || māg|nō tēl|lūrĭs ăm|ōrĕ

ēgrēs|si ōptāt|ā || pŏtĭ|ūntūr| Trōĕs hăr|ēnā

ēt sălĕ| tābēn|tēs || ār|tūs īn| lītŏrĕ| pōnūnt.

āc prīm|ūm sĭlĭc|ī || scīn|tīllam ēx|cūdĭt Ăc|hātēs

sūccēp|ītque īg|nēm || fŏlĭ|īs āt|que ārĭdă| cīrcŭm175

nūtrīm|ēntă dĕd|īt || răpŭ|ītque īn| fōmĭtĕ| flāmmăm.

tūm Cĕrĕr|ēm cōr|rūptam || ūn|dīs Cĕrĕ|ālĭă|que ārmă

ēxpĕdĭ|ūnt fēs|sī || rēr|ūm, frūg|ēsquĕ rĕc|ēptās

ēt tōr|rērĕ păr|ānt || flām|mīs ēt| frāngĕrĕ| sāxō.

Aēnē|ās scŏpŭl|um īntĕrĕ|ā || cōn|scēndĭt, ĕt| ōmnĕm180

prōspēc|tūm lāt|ē || pĕlăg|ō pĕtĭt|, Ānthĕă| sī quĕm

iāctāt|ūm vēn|tō || vĭdĕ|āt Phrŷgĭ|āsquĕ bĭr|ēmēs

aūt Căpŷn| aūt cēl|sīs || īn| pūppĭbŭs| ārmă Că|īcī.

nāvem īn| cōnspēc|tū || nūl|lām, trēIs lītŏrĕ| cērvōs

prōspĭcĭt| ērrān|tēs; || hōs| tōta ār|mēntă sĕ|quūntŭr185

ā tēr|go ēt lōn|gūm || pēr| vāllēIs pāscĭtŭr| āgmĕn.

cōnstĭtĭt| hīc ār|cūmquĕ || măn|ū cĕlĕr|ēsquĕ săg|īttās

cōrrĭpŭ|īt fīd|ūs || quaē| tēlă gĕr|ēbăt Ăc|hātēs,

dūctōr|ēsque īp|sōs || prīm|ūm căpĭt|a āltă fĕr|ēntēs

cōrnĭbŭs| ārbŏrĕ|īs || stēr|nīt, tūm| vūlgŭs ĕt| ōmnĕm190

mīscĕt ăg|ēns tēl|īs || nĕmŏr|a īntēr| frōndĕă| tūrbăm;

nēc prĭŭs| ābsīs|tīt || quām| sēptem īn|gēntĭă| vīctŏr

cōrpŏră| fūndăt hŭm|i ēt || nŭmĕr|ūm cūm| nāvĭbŭs| aēquĕt;

hīnc pōr|tūm pĕtĭt| ēt || sŏcĭ|ōs pār|tītŭr ĭn| ōmnēs.

vīnă bŏn|ūs quaē| deīndĕ || căd|īs ŏnĕr|ārăt Ăc|ēstēs195

lītŏrĕ| Trīnăcrĭ|ō || dĕdĕr|ātque ăbĕ|ūntĭbŭs| hērōs

dīvĭdĭt|, ēt dīc|tīs || maēr|ēntĭă| pēctŏră| mūlcĕt:

“Ō sŏcĭ|ī (nĕque ĕn|im īgnār|ī || sŭmŭs| āntĕ măl|ōrŭm),

ō pās|sī grăvĭ|ōră, || dăb|īt dĕŭs| hīs quŏquĕ| fīnĕm.

vōs ēt| ScŶllaē|ām || răbĭ|ēm pĕnĭt|ūsquĕ sŏn|āntēs200

āccēs|tīs scŏpŭl|ōs, || vōs| ēt CŶc|lōpĭă| sāxă

ēxpēr|tī: rĕvŏc|āte || ănĭm|ōs maēs|tūmquĕ tĭm|ōrĕm

mīttĭtĕ|; fōrsăn ĕt| haēc || ōl|īm mĕmĭn|īssĕ iŭv|ābĭt.

pēr vărĭ|ōs cās|ūs, || pēr| tōt dīs|crīmĭnă| rērŭm

tēndĭmŭs| īn Lătĭ|ūm, || sēd|ēs ŭbĭ| fātă quĭ|ētās205

ōstēn|dūnt; īl|līc || fās| rēgnă rĕs|ūrgĕrĕ| Trōiaē.

dūrāt|e, ēt vōs|mēt || rēb|ūs sēr|vātĕ sĕc|ūndīs.”

Tālĭă| vōcĕ rĕf|ērt || cūr|īsque īn|gēntĭbŭs| aēgĕr

spēm vūl|tū sĭmŭl|āt, || prĕmĭt| āltūm| cōrdĕ dŏl|ōrĕm.

Cōrrĭpŭ|ērĕ vĭ|am īntĕrĕ|ā, || quā| sēmĭtă| mōnstrăt,

iāmque ās|cēndēb|ānt || cōl|lēm, quī| plūrĭmŭs| ūrbī

īmmĭnĕt| ādvēr|sāsque || ās|pēctāt| dēsŭpĕr| ārcēs.420

mīrāt|ūr mōl|em Aēnē|ās, || māg|ālĭă| quōndăm,

mīrāt|ūr pōr|tās || strĕpĭt|ūmque ēt| strātă vĭ|ārŭm.

īnstān|t ārdēn|tēs || Tŷrĭ|ī: pār|s dūcĕrĕ| mūrōs

mōlīr|īque ār|cem ēt || mănĭb|ūs sūb|vōlvĕrĕ| sāxă,

pārs ōp|tārĕ lŏc|ūm || tēc|to ēt cōn|clūdĕrĕ| sūlcō;425

iūră măg|īstrāt|ūsquĕ || lĕg|ūnt sān|ctūmquĕ sĕn|ātŭm.

hīc pōr|tūs ălĭ|i ēffŏdĭ|ūnt; || hīc| āltă thĕ|ātrīs

fūndām|ēntă lŏc|ānt || ălĭ|i, īmmān|ēsquĕ cŏl|ūmnās

rūpĭbŭs| ēxcīd|ūnt, || scaēn|īs dĕcŏr|a āptă fŭt|ūrīs:

quālĭs ăp|ēs aēs|tātĕ || nŏv|ā pēr| flōrĕă| rūră430

ēxēr|cēt sūb| sōlĕ || lăb|ōr, cūm| gēntĭs ăd|ūltōs

ēdūc|ūnt fēt|ūs, || aūt| cūm lī|quēntĭă| mēllă

stīpān|t ēt dūl|cī || dīs|tēndūn|t nēctărĕ| cēllās,

aūt ŏnĕr|a āccĭpĭ|ūnt || vĕnĭ|ēntum, aūt| āgmĭnĕ| fāctō

īgnāv|ūm fūc|ōs || pĕcŭs| ā praēs|ēpĭbŭs| ārcēnt;435

fērvĕt ŏp|ūs rĕdŏl|ēntquĕ || thŷm|ō frāg|lāntĭă| mēllă.

“ō fōr|tūnāt|ī, || quōr|ūm iām| moēnĭă| sūrgūnt!”

Aēnē|ās ăĭt| ēt || fās|tīgĭă| sūspĭcĭt| ūrbĭs.

īnfēr|t sē saēp|tūs || nĕbŭl|ā (mīr|ābĭlĕ| dīctū)

pēr mĕdĭ|ōs, mīs|cētquĕ || vĭr|īs nĕquĕ| cērnĭtŭr| ūllī.440

Haēc dūm| Dārdănĭ|o Aēnē|aē || mīr|āndă vĭd|ēntŭr,

dūm stŭpĕt| ōbtūt|ūque || haēr|ēt dēf|īxŭs ĭn| ūnō,495

rēgīn|a ād tēm|plūm, || fōr|mā pūl|chērrĭmă| Dīdō,

īncēs|sīt māg|nā || iŭvĕn|ūm stīp|āntĕ căt|ērvā.

quālĭs ĭn| Eūrōt|aē || rīp|īs aūt| pēr iŭgă| CŶnthī

ēxēr|cēt Dī|ānă || chŏr|ōs, quām| mīllĕ sĕc|ūtaē

hīnc āt|que hīnc glŏmĕr|āntŭr || Ŏr|ēădĕs|; īllă phăr|ētrăm500

fērt ŭmĕr|ō grădĭ|ēnsquĕ || dĕ|ās sŭpĕr|ēmĭnĕt| ōmnēs

(Lātōn|aē tăcĭt|ūm || pēr|tēmptān|t gaūdĭă| pēctŭs):

tālĭs ĕr|āt Dīd|ō, || tāl|ēm sē| laētă fĕr|ēbăt

pēr mĕdĭ|ōs īn|stāns || ŏpĕr|ī rēg|nīsquĕ fŭt|ūrīs.

tūm fŏrĭb|ūs dīv|aē, || mĕdĭ|ā tēs|tūdĭnĕ| tēmplī,505

saēpta ār|mīs sŏlĭ|ōque || āl|tē sūb|nīxă rĕs|ēdĭt.

iūră dăb|āt lēg|ēsquĕ || vĭr|īs, ŏpĕr|ūmquĕ lăb|ōrĕm

pārtĭbŭs| aēquāb|āt || iūs|tīs aūt| sōrtĕ trăh|ēbăt:

cūm sŭbĭt|o Aēnē|ās || cōn|cūrsu āc|cēdĕrĕ| māgnō

Ānthĕă| Sērgēs|tūmquĕ || vĭd|ēt fōr|tēmquĕ Clŏ|ānthŭm510

Teūcrōr|ūmque ălĭ|ōs, || āt|ēr quōs| aēquŏrĕ| tūrbō

dīspŭlĕr|āt pĕnĭt|ūsque || ălĭ|ās āv|ēxĕrăt| ōrās.

ōbstĭpŭ|īt sĭmŭl| īpsĕ, || sĭm|ūl pēr|cūssŭs Ăc|hātēs

laētĭtĭ|āquĕ mĕt|ūque; || ăvĭd|ī cōn|iūngĕrĕ| dēxtrās

ārdēb|ānt, sēd| rēs || ănĭm|ōs īn|cōgnĭtă| tūrbăt.515

dīssĭmŭl|ānt ēt| nūbĕ || căv|ā spĕcŭl|āntŭr ăm|īctī

quaē fōr|tūnă vĭr|īs, || clās|sēm quō| lītŏrĕ| līnquānt,

quīd vĕnĭ|ānt; cūn|ctīs || nām| lēctī| nāvĭbŭs| ībānt

ōrān|tēs vĕnĭ|am ēt || tēm|plūm clām|ōrĕ pĕt|ēbānt.

Pōstquam īn|trōgrēs|si ēt || cōr|ām dătă| cōpĭă| fāndī,520

māxĭmŭs| Īlĭŏn|eūs || plăcĭd|ō sīc| pēctŏrĕ| coēpĭt:

“ō rēg|īnă, nŏv|ām || cŭĭ| cōndĕrĕ| Iūppĭtĕr| ūrbĕm

iūstĭtĭ|āquĕ dĕd|īt || gēn|tēs frēn|ārĕ sŭp|ērbās,

Trōēs| tē mĭsĕr|ī, || vēn|tīs mărĭ|a ōmnĭă| vēctī,

ōrām|ūs: prŏhĭb|e īnfān|dōs || ā| nāvĭbŭs| īgnēs,525

pārcĕ pĭ|ō gĕnĕr|i ēt || prŏpĭ|ūs rēs| āspĭcĕ| nōstrās.

nōn nōs| aūt fēr|rō || Lĭbŷc|ōs pŏpŭl|ārĕ pĕn|ātēs

vēnĭmŭs|, aūt rāp|tās || ād| lītŏră| vērtĕrĕ| praēdās;

nōn ĕă| vīs ănĭm|ō || nēc| tāntă sŭp|ērbĭă| vīctīs.

ēst lŏcŭs|, Hēspĕrĭ|ām || Grā|ī cōg|nōmĭnĕ| dīcūnt,530

tērra ān|tīquă, pŏt|ēns || ār|mīs āt|que ūbĕrĕ| glaēbaē;

Oēnōt|rī cŏlŭ|ērĕ || vĭr|ī; nūn|c fāmă mĭn|ōrēs

Ītălĭ|ām dīx|īssĕ || dŭc|īs dē| nōmĭnĕ| gēntĕm.

hīc cūrsūs fŭĭt,

cūm sŭbĭt|o ādsūr|gēns || flūc|tū nīm|bōsŭs Ŏr|īōn535

īn vădă| caēcă tŭl|īt || pĕnĭt|ūsquĕ prŏc|ācĭbŭs| Aūstrīs

pērque ūn|dās sŭpĕr|āntĕ || săl|ō pēr|que īnvĭă| sāxă

dīspŭlĭt|; hūc paūc|ī || vēs|trīs ād|nāvĭmŭs| ōrīs.

quōd gĕnŭs| hōc hŏmĭn|ūm? || quaēv|e hūnc tām| bārbără| mōrĕm

pērmīt|tīt pătrĭ|a? hōspĭtĭ|ō || prŏhĭb|ēmŭr hăr|ēnaē;540

bēllă cĭ|ēnt prīm|āquĕ || vĕt|ānt cōn|sīstĕrĕ| tērrā.

sī gĕnŭs| hūmān|um ēt || mōr|tālĭă| tēmnĭtĭs| ārmă,

āt spēr|ātĕ dĕ|ōs || mĕmŏr|ēs fān|di ātquĕ nĕf|āndī.

rēx ĕrăt| Aēnē|ās || nōb|īs, quō| iūstĭŏr| āltĕr

nēc pĭĕt|ātĕ fŭ|īt, || nēc| bēllō| māiŏr ĕt| ārmīs.545

quēm sī| fātă vĭr|ūm || sēr|vānt, sī| vēscĭtŭr| aūrā

aēthĕrĭ|ā nĕque ăd|hūc || crūd|ēlĭbŭs| ōccŭbăt| ūmbrīs,

nōn mĕtŭs|, ōffĭcĭ|ō || nēc| tē cēr|tāssĕ prĭ|ōrĕm

paēnĭtĕ|āt. sūn|t ēt || Sĭcŭl|īs rĕgĭ|ōnĭbŭs| ūrbēs

ārmăquĕ| Trōiān|ōque || ā| sānguĭnĕ| clārŭs Ăc|ēstēs.550

quāssāt|ām vēn|tīs || lĭcĕ|āt sūb|dūcĕrĕ| clāssĕm

ēt sīl|vīs āp|tārĕ || trăb|ēs ēt| strīngĕrĕ| rēmōs,

sī dătŭr| Ītălĭ|ām || sŏcĭ|īs ēt| rēgĕ rĕc|ēptō

tēndĕre, ŭt| Ītălĭ|ām || laēt|ī Lătĭ|ūmquĕ pĕt|āmŭs;

sīn āb|sūmptă săl|ūs, || ēt| tē, pătĕr| ōptĭmĕ| Teūcrŭm,555

pōntŭs hăb|ēt Lĭbŷ|aē || nēc| spēs iām| rēstăt Ĭ|ūlī,

āt frĕtă| Sīcănĭ|aē || sāl|tēm sēd|ēsquĕ păr|ātās,

ūnde hūc| ādvēc|tī, || rēg|ēmquĕ pĕt|āmŭs Ăc|ēstēn.”

tālĭbŭs| Īlĭŏn|eūs; || cūn|ctī sĭmŭl| ōrĕ frĕm|ēbānt

Dārdănĭdaē.560

Tūm brĕvĭt|ēr Dīd|ō || vūl|tūm dēm|īssă prŏf|ātŭr:

“sōlvĭtĕ| cōrdĕ mĕt|ūm, || Teūc|rī, sēc|lūdĭtĕ| cūrās.

rēs dūr|a ēt rēg|nī || nŏvĭt|ās mē| tālĭă| cōgūnt

mōlīr|i ēt lāt|ē || fīn|ēs cūs|tōdĕ tŭ|ērī.

quīs gĕnŭs| Aēnĕăd|ūm, || quīs| Trōiaē| nēscĭăt| ūrbĕm,565

vīrtūt|ēsquĕ vĭr|ōsque || aūt| tānti īn|cēndĭă| bēllī?

nōn ōb|tūnsa ădĕ|ō || gēs|tāmūs| pēctŏră| Poēnī,

nēc tam āv|ērsŭs ĕ|quōs || Tŷrĭ|ā Sōl| iūngĭt ăb| ūrbĕ.

seū vōs| Hēspĕrĭ|ām || māg|nām Sāt|ūrnĭă|que ārvă

sīve Ĕrŷc|īs fīn|ēs || rēg|ēmque ōp|tātĭs Ăc|ēstēn,570

aūxĭlĭ|ō tūt|ōs || dīm|īttam ŏpĭb|ūsquĕ iŭv|ābō.

vūltĭs ĕt| hīs mēc|ūm || părĭt|ēr cōn|sīdĕrĕ| rēgnīs?

ūrbēm| quām stătŭ|ō, || vēs|tra ēst; sūb|dūcĭtĕ| nāvēs;

Trōs Tŷrĭ|ūsquĕ mĭh|ī || nūl|lō dīs|crīmĭne ăg|ētŭr.

ātque ŭtĭn|ām rēx| īpsĕ || Nŏt|ō cōm|pūlsŭs ĕ|ōdĕm575

ādfŏrĕt| Aēnē|ās! || ĕquĭd|ēm pēr| lītŏră| cērtōs

dīmīt|tam ēt Lĭbŷ|aē || lūs|trāre ēx|trēmă iŭb|ēbō,

sī quĭbŭs| ēiēc|tūs || sīl|vīs aūt| ūrbĭbŭs| ērrăt.”

Prīmŭs ĭb|i ānte ōm|nēs || māg|nā cŏmĭt|āntĕ căt|ērvā40

Lāŏcŏ|ōn ār|dēns || sūm|mā dēc|ūrrĭt ăb| ārcĕ,

ēt prŏcŭl| “ō mĭsĕr|ī, || quaē| tānta īn|sānĭă|, cīvēs?

crēdĭtĭs| āvēc|tōs || hōs|tēs? aūt| ūllă pŭt|ātĭs

dōnă căr|ērĕ dŏl|īs || Dănă|ūm? sīc| nōtŭs Ŭl|īxēs?

aūt hōc| īnclūs|ī || līg|no ōccūl|tāntŭr Ăc|hīvī,45

aūt haēc| īn nōs|trōs || făbrĭc|āta ēs|t māchĭnă| mūrōs,

īnspēc|tūră dŏm|ōs || vēn|tūrăquĕ| dēsŭpĕr| ūrbī,

aūt ălĭ|quīs lătĕt| ērrŏr; || ĕ|quō nē| crēdĭtĕ|, Teūcrī.

quīdquĭd ĭd| ēst, tĭmĕ|ō || Dănă|ōs ēt| dōnă fĕr|ēntēs.”

sīc fāt|ūs vălĭd|īs || īn|gēntēm| vīrĭbŭs| hāstăm50

īn lătŭs| īnquĕ fĕr|ī || cūr|vām cōm|pāgĭbŭs| ālvŭm

cōntōr|sīt. stĕtĭt| īllă || trĕm|ēns, ŭtĕr|ōquĕ rĕc|ūssō

īnsŏnŭ|ērĕ căv|aē || gĕmĭt|ūmquĕ dĕd|ērĕ căv|ērnaē.

ēt, sī| fātă dĕ|ūm, || sī| mēns nōn| laēvă fŭ|īssĕt,

īmpŭlĕr|āt fēr|ro Ārgŏlĭc|ās || foēd|ārĕ lăt|ēbrās,55

Trōiăquĕ| nūnc stār|ēt, || Prĭăm|īque ār|x āltă măn|ērēs.

Lāŏcŏ|ōn, dūc|tūs || Nēp|tūnō| sōrtĕ săc|ērdōs,

sōllēm|nēs taūr|um īngēn|tēm || māc|tābăt ăd| ārās.

ēcce aūt|ēm gĕmĭn|i ā || Tĕnĕd|ō trān|quīllă pĕr| āltă

(hōrrēs|cō rĕfĕr|ēns) || īm|mēnsīs| ōrbĭbŭs| ānguēs

īncūm|būnt pĕlăg|ō || părĭt|ērque ād| lītŏră| tēndūnt;205

pēctŏră| quōrum īn|tēr || flūc|tūs ār|rēctă iŭb|aēquĕ

sānguĭnĕ|aē sŭpĕr|ānt || ūn|dās, pār|s cētĕră| pōntŭm

pōnĕ lĕg|īt sĭnŭ|ātque || īm|mēnsă vŏl|ūmĭnĕ| tērgă.

fīt sŏnĭt|ūs spūm|āntĕ || săl|ō; iām|que ārvă tĕn|ēbānt

ārdēn|tēsque ŏcŭl|ōs || sūf|fēctī| sānguĭne ĕt| īgnī210

sībĭlă| lāmbēb|ānt || līn|guīs vīb|rāntĭbŭs| ōră.

dīffŭgĭm|ūs vīs|u ēxsān|guēs. || īl|li āgmĭnĕ| cērtō

Lāŏcŏ|ōntă pĕt|ūnt; || ēt| prīmūm| pārvă dŭ|ōrŭm

cōrpŏră| nātōr|ūm || sēr|pēns ām|plēxŭs ŭt|ērquĕ

īmplĭcăt| ēt mĭsĕr|ōs || mōr|sū dēp|āscĭtŭr| ārtūs;215

pōst īp|sum aūxĭlĭ|ō || sŭbĕ|ūntem āc| tēlă fĕr|ēntĕm

cōrrĭpĭ|ūnt spīr|īsquĕ || lĭg|ānt īn|gēntĭbŭs|; ēt iăm

bīs mĕdĭ|um āmplēx|ī, || bīs| cōllō| squāmĕă| cīrcŭm

tērgă dăt|ī sŭpĕr|ānt || căpĭt|e ēt cēr|vīcĭbŭs| āltīs.

īllĕ sĭm|ūl mănĭb|ūs || tēn|dīt dīv|ēllĕrĕ| nōdōs220

pērfūs|ūs sănĭ|ē || vīt|tās āt|rōquĕ vĕn|ēnō,

clāmōr|ēs sĭmŭl| hōrrēn|dōs || ād| sīdĕră| tōllĭt:

quālēIs mūgīt|ūs, || fūg|īt cūm| saūcĭŭs| ārăm

taūrŭs ĕt| īncēr|tam ēxcūs|sīt || cēr|vīcĕ sĕc|ūrĭm.

āt gĕmĭn|ī lāp|sū || dēl|ūbra ād| sūmmă drăc|ōnēs225

ēffŭgĭ|ūnt saēv|aēquĕ || pĕt|ūnt Trīt|ōnĭdĭs| ārcĕm,

sūb pĕdĭb|ūsquĕ dĕ|aē || clĭpĕ|īquĕ sŭb| ōrbĕ tĕg|ūntŭr.

tūm vēr|ō trĕmĕf|āctă || nŏv|ūs pēr| pēctŏră| cūnctīs

īnsĭnŭ|āt păvŏr|, ēt || scĕlŭs| ēxpēn|dīssĕ mĕr|ēntĕm

Lāŏcŏ|ōntă fĕr|ūnt, || sāc|rūm quī| cūspĭdĕ| rōbŭr230

laēsĕrĭt| ēt tēr|gō || scĕlĕr|ātam īn|tōrsĕrĭt| hāstăm.

dūcēn|dum ād sēd|ēs || sĭmŭl|ācrum ōr|āndăquĕ| dīvaē

nūmĭnă cōnclāmānt.

dīvĭdĭm|ūs mūr|ōs || ēt| moēnĭă| pāndĭmŭs| ūrbĭs.

āccīn|gūnt ōm|nēs || ŏpĕr|ī pĕdĭb|ūsquĕ rŏt|ārŭm235

sūbĭcĭ|ūnt lāp|sūs, || ēt| stūppĕă| vīncŭlă| cōllō

īntēn|dūnt; scān|dīt || fāt|ālīs| māchĭnă| mūrōs

fēta ār|mīs. pŭĕr|ī || cīr|cum īnnūp|taēquĕ pŭ|ēllaē

sācră căn|ūnt fūn|ēmquĕ || măn|ū cōn|tīngĕrĕ| gaūdēnt;

īllă sŭb|īt mĕdĭ|aēquĕ || mĭn|āns īn|lābĭtŭr| ūrbī.240

ō pătrĭ|a, ō dīv|ūm || dŏmŭs| Īlĭum ĕt| īnclŭtă| bēllō

moēnĭă| Dārdănĭd|ūm! || quătĕr| īpso īn| līmĭnĕ| pōrtaē

sūbstĭtĭt| ātque ŭtĕr|ō || sŏnĭt|ūm quătĕr| ārmă dĕd|ērĕ;

īnstām|ūs tămĕn| īmmĕmŏr|ēs || caēc|īquĕ fŭr|ōrĕ

ēt mōn|strum īnfēl|īx || sāc|rātā| sīstĭmŭs| ārcĕ.245

tūnc ĕtĭ|ām fāt|īs || ăpĕr|īt Cās|sāndră fŭt|ūrīs

ōră dĕ|ī iūs|sū || nōn| ūmquām| crēdĭtă| Teūcrīs.

nōs dēl|ūbră dĕ|ūm || mĭsĕr|ī, quĭbŭs| ūltĭmŭs| ēssĕt

īllĕ dĭ|ēs, fēs|tā || vēl|āmūs| frōndĕ pĕr| ūrbĕm.

Tēmpŭs ĕr|āt quō| prīmă || quĭ|ēs mōr|tālĭbŭs| aēgrīs

īncĭpĭt| ēt dōn|ō || dīv|ūm grāt|īssĭmă| sērpĭt.

īn sōm|nīs, ēc|ce, ānte || ŏcŭl|ōs maēs|tīssĭmŭs| Hēctŏr270

vīsŭs ăd|ēssĕ mĭh|ī || lār|gōsque ēf|fūndĕrĕ| flētūs,

rāptāt|ūs bīg|īs || ūt| quōndam, āt|ērquĕ crŭ|ēntō

pūlvĕrĕ| pērquĕ pĕd|ēs || trā|iēctūs| lōră tŭm|ēntēs.

eī mĭhĭ|, quālĭs ĕr|āt, || quān|tūm mūt|ātŭs ăb| īllō

Hēctŏrĕ| quī rĕdĭt| ēxŭvĭ|ās || īn|dūtŭs Ăc|hīllī275

vēl Dănă|ūm Phrŷgĭ|ōs || iăcŭl|ātūs| pūppĭbŭs| īgnēs!

squālēn|tēm bār|bam ēt || cōn|crētōs| sānguĭnĕ| crīnēs

vūlnĕră|que īllă gĕr|ēns, || quaē| cīrcūm| plūrĭmă| mūrōs

āccēp|īt pătrĭ|ōs. || ūl|trō flēn|s īpsĕ vĭd|ēbăr

cōmpēl|lārĕ vĭr|um ēt || maēs|tās ēx|prōmĕrĕ| vōcēs:280

“ō lūx| Dārdănĭ|aē, || spēs| ō fīd|īssĭmă| Teūcrŭm,

quaē tān|taē tĕnŭ|ērĕ || mŏr|aē? quĭbŭs| Hēctŏr ăb| ōrīs

ēxspēc|tātĕ vĕn|īs? || ūt| tē pōs|t mūltă tŭ|ōrŭm

fūnĕră|, pōst vărĭ|ōs || hŏmĭn|ūmque ūr|bīsquĕ lăb|ōrēs

dēfēs|si āspĭcĭm|ūs! || quaē| caūsa īn|dīgnă sĕr|ēnōs285

foēdāv|īt vūl|tūs? || aūt| cūr haēc| vūlnĕră| cērnō?”

īllĕ nĭh|īl, nēc| mē || quaēr|ēntēm| vānă mŏr|ātŭr,

sēd grăvĭt|ēr gĕmĭt|ūs || īm|ō dē| pēctŏrĕ| dūcēns,

“heū fŭgĕ|, nātĕ dĕ|ā, || tē|que hīs” ăĭt| “ērĭpĕ| flāmmīs.

hōstĭs hăb|ēt mūr|ōs; || rŭĭt| ālto ā| cūlmĭnĕ| Trōiă.290

sāt pătrĭ|aē Prĭăm|ōquĕ || dăt|ūm: sī| Pērgămă| dēxtrā

dēfēn|dī pōs|sēnt, || ĕtĭ|am hāc dēf|ēnsă fŭ|īssēnt.

sācră sŭ|ōsquĕ tĭb|ī || cōm|mēndāt| Trōiă pĕn|ātēs;

hōs căpĕ| fātōr|ūm || cŏmĭt|ēs, hīs| moēnĭă| quaērĕ

māgnă pĕr|ērrāt|ō || stătŭ|ēs quaē| dēnĭquĕ| pōntō.”295

sīc ăĭt| ēt mănĭb|ūs || vīt|tās Vēs|tāmquĕ pŏt|ēntĕm

aētēr|nūmque ădŷt|īs || ēf|fērt pĕnĕt|rālĭbŭs| īgnĕm.

Āt mē| tūm prīm|ūm || saēv|ūs cīr|cūmstĕtĭt| hōrrŏr.

ōbstĭpŭ|ī; sŭbĭ|īt || cār|ī gĕnĭt|ōrĭs ĭm|āgō,560

ūt rēg|em aēquaēv|ūm || crūd|ēlī| vūlnĕrĕ| vīdī

vītam ēx|hālān|tēm, || sūb|iīt dēs|ērtă Crĕ|ūsă

ēt dīr|ēptă dŏm|ūs || ēt| pārvī| cāsŭs Ĭ|ūlī.

rēspĭcĭ|o ēt quaē| sīt || mē| cīrcūm| cōpĭă| lūstrō.

dēsĕrŭ|ēre ōm|nēs || dēf|ēssi, ēt| cōrpŏră| sāltū565

ād tēr|rām mīs|ēre || aūt| īgnĭbŭs| aēgră dĕd|ērĕ.

Iāmque ădĕ|ō sŭpĕr| ūnŭs || ĕr|ām, cūm| līmĭnă| Vēstaē

sērvān|tem ēt tăcĭt|ām || sēc|rēta īn| sēdĕ lăt|ēntĕm

TŶndărĭd|a āspĭcĭ|ō; || dān|t clāram īn|cēndĭă| lūcĕm

ērrān|tī pās|sīmque || ŏcŭl|ōs pēr| cūnctă fĕr|ēntī.570

īllă sĭb|i īnfēs|tōs || ēv|ērsa ōb| Pērgămă| Teūcrōs

ēt Dănă|ūm poēn|am ēt || dēs|ērtī| cōniŭgĭs| īrās

praēmĕtŭ|ēns, Trō|iae ēt || pătrĭ|aē cōm|mūnĭs Ĕr|īnŷs,

ābdĭdĕr|āt sēs|e ātque || ār|īs īn|vīsă sĕd|ēbăt.

ēxār|sēre īg|nēs || ănĭm|ō; sŭbĭt| īră căd|ēntĕm575

ūlcīs|cī pătrĭ|am ēt || scĕlĕr|ātās| sūmĕrĕ| poēnās.

“scīlĭcĕt| haēc Spār|tam īncŏlŭm|īs || pătrĭ|āsquĕ Mŷc|ēnās

āspĭcĭ|ēt, pār|tōque || īb|īt rēg|īnă trĭ|ūmphō?

cōniŭgĭ|ūmquĕ dŏm|ūmquĕ || păt|rēs nāt|ōsquĕ vĭd|ēbĭt

Īlĭăd|ūm tūr|ba ēt || Phrŷgĭ|īs cŏmĭt|ātă mĭn|īstrīs?580

ōccĭdĕr|īt fēr|rō || Prĭăm|ūs? Trō|ia ārsĕrĭt| īgnī?

Dārdănĭ|ūm tŏtĭ|ēns || sūd|ārīt| sānguĭnĕ| lītŭs?

nōn ĭtă|. nāmque ēt|sī || nūl|lūm mĕmŏr|ābĭlĕ| nōmĕn

fēmĭnĕ|a īn poēn|a ēst, || hăbĕt| haēc vīc|tōrĭă| laūdĕm;

ēxstīn|xīssĕ nĕf|ās || tămĕn| ēt sūm|psīssĕ mĕr|ēntēs585

laūdāb|ōr poēn|ās, || ănĭm|ūmque ēx|plēssĕ iŭv|ābĭt

ūltrīc|īs flām|mae ēt || cĭnĕr|ēs sătĭ|āssĕ mĕ|ōrŭm.”

tālĭă| iāctāb|am ēt || fŭrĭ|ātā| mēntĕ fĕr|ēbăr,

cūm mĭhĭ| sē, nōn| ānte || ŏcŭl|īs tām| clāră, vĭd|ēndăm

ōbtŭlĭt| ēt pūr|ā || pēr| nōctem īn| lūcĕ rĕf|ūlsĭt590

ālmă păr|ēns, cōn|fēssă || dĕ|ām quāl|īsquĕ vĭd|ērī

caēlĭcŏl|īs ēt| quāntă || sŏl|ēt, dēx|trāquĕ prĕh|ēnsŭm

cōntĭnŭ|īt rŏsĕ|ōque || haēc| īnsŭpĕr| āddĭdĭt| ōrĕ:

“nātĕ, quĭs| īndŏmĭt|ās || tān|tūs dŏlŏr| ēxcĭtăt| īrās?

quīd fŭrĭs|? aūt quōn|ām || nōs|trī tĭbĭ| cūră rĕc|ēssĭt?595

nōn prĭŭs| āspĭcĭ|ēs || ŭbĭ| fēssum aēt|ātĕ păr|ēntĕm

līquĕrĭs| Ānchīs|ēn, || sŭpĕr|ēt cōn|iūnxnĕ Crĕ|ūsă

Āscănĭ|ūsquĕ pŭ|ēr? || quōs| ōmnēIs ūndĭquĕ| Grāiaē

cīrcum ēr|rānt ăcĭ|ēs || ēt|, nī mĕă| cūră rĕs|īstăt,

iām flām|maē tŭlĕr|īnt || ĭnĭm|īcŭs ĕt| haūsĕrĭt| ēnsĭs.600

nōn tĭbĭ| TŶndărĭd|īs || făcĭ|ēs īn|vīsă Lăc|aēnaē

cūlpāt|ūsvĕ Păr|īs, || dīv|um īnclēm|ēntĭă|, dīvŭm

hās ēv|ērtĭt ŏp|ēs || stēr|nītque ā| cūlmĭnĕ| Trōiăm.

āspĭcĕ| (nāmque ōm|nēm, || quaē| nūnc ōb|dūctă tŭ|ēntī

mōrtāl|ēs hĕbĕt|āt || vīs|ūs tĭbi ĕt| ūmĭdă| cīrcŭm605

cālīg|āt, nūb|em ērĭpĭ|ām; || tū| nē quă păr|ēntĭs

iūssă tĭm|ē nĕŭ| praēcēp|tīs || pār|ērĕ rĕc|ūsā):

hīc, ŭbĭ| dīsiēc|tās || mōl|ēs āv|ūlsăquĕ| sāxīs

sāxă vĭd|ēs, mīx|tōque || ūn|dāntēm| pūlvĕrĕ| fūmŭm,

Nēptūn|ūs mūr|ōs || māg|nōque ēm|ōtă trĭd|ēntī610

fūndām|ēntă quăt|īt || tōt|āmque ā| sēdĭbŭs| ūrbĕm

ērŭĭt|. hīc Iūn|ō || Scaē|ās saēv|īssĭmă| pōrtās

prīmă tĕn|ēt sŏcĭ|ūmquĕ || fŭr|ēns ā| nāvĭbŭs| āgmĕn

fērro āccīnctă vŏcāt.

iām sūm|mās ār|cēs || Trīt|ōnĭă|, rēspĭcĕ|, Pāllăs615

īnsēd|īt nīm|bo ēffūl|gēns || ēt| Gōrgŏnĕ| saēvă.

īpsĕ păt|ēr Dănă|īs || ănĭm|ōs vīr|ēsquĕ sĕc|ūndās

sūffĭcĭt|, īpsĕ dĕ|ōs || īn| Dārdănă| sūscĭtăt| ārmă.

ērĭpĕ|, nātĕ, fŭg|ām || fīn|ēmque īm|pōnĕ lăb|ōrī;

nūsquam ăbĕr|o ēt tūt|ūm || pătrĭ|ō tē| līmĭnĕ| sīstăm.”620

Īntĕrĕ|ā māg|nō || mīs|cērī| mūrmŭrĕ| caēlŭm160

īncĭpĭt|, īnsĕquĭt|ūr || cōm|mīxtā| grāndĭnĕ| nīmbŭs,

ēt Tŷrĭ|ī cŏmĭt|ēs || pās|sim ēt Trō|iānă iŭv|ēntūs

Dārdănĭ|ūsquĕ nĕp|ōs || Vĕnĕr|īs dīv|ērsă pĕr| āgrōs

tēctă mĕt|ū pĕtĭ|ērĕ; || rŭ|ūnt dē| mōntĭbŭs| āmnēs.

spēlūn|cām Dīd|ō || dūx| ēt Trō|iānŭs ĕ|āndĕm165

dēvĕnĭ|ūnt. prīm|a ēt || Tēl|lūs ēt| prōnŭbă| Iūnō

dānt sīg|nūm; fūl|sēre || īg|nēs ēt| cōnscĭŭs| aēthēr

cōnŭbĭ|īs sūm|mōque || ŭlŭl|ārūn|t vērtĭcĕ| NŶmphaē.

īllĕ dĭ|ēs prīm|ūs || lēt|ī prīm|ūsquĕ măl|ōrŭm

caūsă fŭ|īt; nĕque ĕn|īm || spĕcĭ|ē fām|āvĕ mŏv|ētŭr170

nēc iām| fūrtīv|ūm || Dīd|ō mĕdĭt|ātŭr ăm|ōrĕm:

cōniŭgĭ|ūm vŏcăt|, hōc || praēt|ēxīt| nōmĭnĕ| cūlpăm.

Ēxtēm|plō Lĭbŷ|aē || māg|nās īt| Fāmă pĕr| ūrbēs,

Fāmă, măl|ūm quā| nōn || ălĭ|ūd vēl|ōcĭŭs| ūllŭm:

mōbĭlĭt|ātĕ vĭg|ēt || vīr|ēsque ād|quīrĭt ĕ|ūndō,175

pārvă mĕt|ū prīm|ō, || mōx| sēse āt|tōllĭt ĭn| aūrās

īngrĕdĭt|ūrquĕ sŏl|o ēt || căpŭt| īntēr| nūbĭlă| cōndĭt.

īllām| Tērră păr|ēns || īr|a īnrīt|ātă dĕ|ōrŭm

ēxtrēm|am, ūt pĕrhĭb|ēnt, || Coē|o Ēncĕlăd|ōquĕ sŏr|ōrĕm

prōgĕnŭ|īt pĕdĭb|ūs || cĕlĕr|em ēt pēr|nīcĭbŭs| ālīs,180

mōnstrum hōr|rēndum, īn|gēns, || cŭĭ| quōt sūn|t cōrpŏrĕ| plūmaē,

tōt vĭgĭl|ēs ŏcŭl|ī || sūb|tēr (mīr|ābĭlĕ| dīctū),

tōt līn|guaē, tŏtĭd|em ōră || sŏn|ānt, tōt| sūbrĭgĭt| aūrēs.

nōctĕ vŏl|āt caēl|ī || mĕdĭ|ō tēr|raēquĕ pĕr| ūmbrăm

strīdēn|s, nēc dūl|cī || dēc|līnāt| lūmĭnă| sōmnō;185

lūcĕ sĕd|ēt cūs|tōs || aūt| sūmmī| cūlmĭnĕ| tēctī

tūrrĭbŭs| aūt āl|tīs, || ēt| māgnās| tērrĭtăt| ūrbēs,

tām fīc|tī prāv|īquĕ || tĕn|āx quām| nūntĭă| vērī.

haēc tūm| mūltĭplĭc|ī || pŏpŭl|ōs sēr|mōnĕ rĕp|lēbăt

gaūdēn|s, ēt părĭt|ēr || fāc|ta ātque īn|fēctă căn|ēbăt:190

vēnīs|se Aēnē|ān || Trō|iānō| sānguĭnĕ| crētŭm,

cuī sē| pūlchră vĭr|ō || dīg|nētūr| iūngĕrĕ| Dīdō;

nūnc hĭĕm|em īntēr| sē || lūx|ū, quām| lōngă, fŏv|ērĕ

rēgnōr|um īmmĕmŏr|ēs || tūr|pīquĕ cŭp|īdĭnĕ| cāptōs.

haēc pās|sīm dĕă| foēdă || vĭr|ūm dīf|fūndĭt ĭn| ōră.195

prōtĭnŭs| ād rēg|ēm || cūr|sūs dēt|ōrquĕt Ĭ|ārbān

īncēn|dītque ănĭm|ūm || dīc|tīs āt|que āggĕrăt| īrās.

Hīc Hām|mōnĕ săt|ūs || rāp|tā Gărăm|āntĭdĕ| nŶmphā

tēmplă Iŏv|ī cēn|tūm || lāt|īs īm|mānĭă| rēgnīs,

cēntum ār|ās pŏsŭ|īt || vĭgĭl|ēmquĕ săc|rāvĕrăt| īgnĕm,200

ēxcŭbĭ|ās dīv|um aētēr|nās, || pĕcŭd|ūmquĕ crŭ|ōrĕ

pīnguĕ sŏl|um ēt vărĭ|īs || flōr|ēntĭă| līmĭnă| sērtīs.

īsque ām|ēns ănĭm|i ēt || rūm|ōre āc|cēnsŭs ăm|ārō

dīcĭtŭr| ānte ār|ās || mĕdĭ|a īntēr| nūmĭnă| dīvŭm

mūltă Iŏv|ēm mănĭb|ūs || sūp|plēx ōr|āssĕ sŭp|īnīs:205

“Iūppĭtĕr| ōmnĭpŏt|ēns, || cŭĭ| nūnc Maūr|ūsĭă| pīctīs

gēns ĕpŭl|ātă tŏr|īs || Lēn|aēūm| lībăt hŏn|ōrĕm,

āspĭcĭs| haēc? ān| tē, || gĕnĭt|ōr, cūm| fūlmĭnă| tōrquēs

nēquī|quam hōrrēm|ūs, || caēc|īque īn| nūbĭbŭs| īgnēs

tērrĭfĭc|ānt ănĭm|ōs || ĕt ĭn|ānĭă| mūrmŭră| mīscēnt?210

fēmĭnă|, quaē nōs|trīs || ēr|rāns īn| fīnĭbŭs| ūrbĕm

ēxĭgŭ|ām prĕtĭ|ō || pŏsŭ|īt, cŭĭ| lītŭs ăr|āndŭm

cuīquĕ lŏc|ī lēg|ēs || dĕdĭm|ūs, cōn|ūbĭă| nōstră

rēppŭlĭt| āc dŏmĭn|um Aēnē|ān || īn| rēgnă rĕc|ēpĭt.

ēt nūn|c īllĕ Păr|īs || cūm| sēmĭvĭr|ō cŏmĭt|ātū,215

Maēŏnĭ|ā mēn|tūm || mīt|rā crīn|ēmquĕ măd|ēntĕm

sūbnēx|ūs, rāp|tō || pŏtĭt|ūr: nōs| mūnĕră| tēmplīs

quīppĕ tŭ|īs fĕrĭm|ūs || fām|āmquĕ fŏv|ēmŭs ĭn|ānĕm.”

ūt prīm|um ālāt|īs || tĕtĭg|īt māg|ālĭă| plāntīs,

Aēnē|ān fūn|dāntem || ār|cēs āc| tēctă nŏv|āntĕm260

cōnspĭcĭt|. ātque īl|lī || stēl|lātūs| iāspĭdĕ| fūlvā

ēnsĭs ĕr|āt Tŷrĭ|ōque || ār|dēbāt| mūrĭcĕ| laēnă

dēmīs|sa ēx ŭmĕr|īs, || dīv|ēs quaē| mūnĕră| Dīdō

fēcĕrăt|, ēt tĕnŭ|ī || tēl|ās dīs|crēvĕrăt| aūrō.

cōntĭnŭ|o īnvād|īt: || “tū| nūnc Kār|thāgĭnĭs| āltaē265

fūndām|ēntă lŏc|ās || pūl|chrāmque ūx|ōrĭŭs| ūrbĕm

ēxstrŭĭs|? heū, rēg|nī || rēr|ūmque ōb|lītĕ tŭ|ārŭm!

īpsĕ dĕ|ūm tĭbĭ| mē || clār|ō dēm|īttĭt Ŏl|Ŷmpō

rēgnāt|ōr, caēl|um ēt || tēr|rās quī| nūmĭnĕ| tōrquĕt,

īpse haēc| fērrĕ iŭb|ēt || cĕlĕr|ēs mān|dātă pĕr| aūrās:270

quīd strŭĭs|? aūt quā| spē || Lĭbŷc|īs tĕrĭs| ōtĭă| tērrīs?

sī tē| nūllă mŏv|ēt || tān|tārūm| glōrĭă| rērŭm

nēc sŭpĕr| īpsĕ tŭ|ā || mōl|īrīs| laūdĕ lăb|ōrĕm,

Āscănĭ|ūm sūr|gēntem || ēt| spēs hēr|ēdĭs Ĭ|ūlī

rēspĭcĕ|, cuī rēg|num Ītălĭ|aē || Rōm|ānăquĕ| tēllūs275

dēbēt|ūr.” tāl|ī || CŶl|lēnĭŭs| ōrĕ lŏc|ūtŭs

mōrtāl|ēs vīs|ūs || mĕdĭ|ō sēr|mōnĕ rĕl|īquĭt

ēt prŏcŭl| īn tĕnŭ|em ēx || ŏcŭl|īs ēv|ānŭĭt| aūrăm.

Āt vēr|o Aēnē|ās || ās|pēctu ōb|mūtŭĭt| āmēns,

ārrēc|taēque hōr|rōrĕ || cŏm|ae ēt vōx| faūcĭbŭs| haēsĭt.280

ārdĕt ăb|īrĕ fŭg|ā || dūl|cēsquĕ rĕl|īnquĕrĕ| tērrās,

āttŏnĭt|ūs tān|tō || mŏnĭt|u īmpĕrĭ|ōquĕ dĕ|ōrŭm.

heū quĭd ăg|āt? quō| nūnc || rēg|īnam ām|bīrĕ fŭr|ēntĕm

aūdĕăt| ādfāt|ū? || quaē| prīma ēx|ōrdĭă| sūmăt?

ātque ănĭm|ūm nūn|c hūc || cĕlĕr|ēm nūn|c dīvĭdĭt| īllūc285

īn pār|tēsquĕ răp|īt || vărĭ|ās pēr|que ōmnĭă| vērsăt.

haēc āl|tērnān|tī || pŏtĭ|ōr sēn|tēntĭă| vīsa ēst:

Mnēsthĕă| Sērgēs|tūmquĕ || vŏc|āt fōr|tēmquĕ Sĕr|ēstŭm,

clāssem āp|tēnt tăcĭt|ī || sŏcĭ|ōsque ād| lītŏră| cōgānt,

ārmă păr|ēnt ēt| quaē || rēb|ūs sīt| caūsă nŏv|āndīs290

dīssĭmŭl|ēnt; sēs|e īntĕrĕ|ā, || quān|do ōptĭmă| Dīdō

nēscĭăt| ēt tān|tōs || rūm|pī nōn| spērĕt ăm|ōrēs,

tēmptāt|ūrum ădĭt|ūs || ēt| quaē mōl|līssĭmă| fāndī

tēmpŏră|, quīs rēb|ūs || dēx|tēr mŏdŭs|. ōcĭŭs| ōmnēs

īmpĕrĭ|ō laēt|ī || pār|ēnt ēt| iūssă făc|ēssūnt.295

Āt rēg|īnă dŏl|ōs || (quīs| fāllĕrĕ| pōssĭt ăm|āntĕm?)

praēsēn|sīt, mōt|ūsque || ēx|cēpīt| prīmă fŭt|ūrōs

ōmnĭă| tūtă tĭm|ēns. || ĕăd|em īmpĭă| Fāmă fŭr|ēntī

dētŭlĭt| ārmār|ī || clās|sēm cūr|sūmquĕ păr|ārī.

saēvĭt ĭn|ōps ănĭm|ī || tōt|āmque īn|cēnsă pĕr| ūrbĕm300

bācchāt|ūr, quāl|īs || cōm|mōtīs| ēxcĭtă| sācrīs

ThŶiăs, ŭb|i aūdīt|ō || stĭmŭl|ānt trĭĕt|ērĭcă| Bācchō

ōrgĭă| nōctūr|nūsquĕ || vŏc|āt clām|ōrĕ Cĭt|haērōn.

tāndem hīs| Aēnē|ān || cōm|pēllāt| vōcĭbŭs| ūltrō:

“dīssĭmŭl|āre ĕtĭ|ām || spēr|āstī|, pērfĭdĕ|, tāntŭm305

pōssĕ nĕf|ās tăcĭt|ūsquĕ || mĕ|ā dēc|ēdĕrĕ| tērrā?

nēc tē| nōstĕr ăm|ōr || nēc| tē dătă| dēxtĕră| quōndăm

nēc mŏrĭt|ūră tĕn|ēt || crūd|ēlī| fūnĕrĕ| Dīdō?

quīn ĕtĭ|am hībēr|nō || mōl|īrī| sīdĕrĕ| clāssĕm

ēt mĕdĭ|īs prŏpĕr|ās || Ăquĭl|ōnĭbŭs| īrĕ pĕr| āltŭm,310

crūdēl|īs? quīd|, sī || nōn| ārva ălĭ|ēnă dŏm|ōsquĕ

īgnōt|ās pĕtĕr|ēs, || ēt| Trōia ān|tīquă măn|ērĕt,

Trōiă pĕr| ūndōs|ūm || pĕtĕr|ētūr| clāssĭbŭs| aēquŏr?

mēnĕ fŭg|īs? pĕr ĕg|o hās || lăcrĭm|ās dēx|trāmquĕ tŭ|ām tē

(quāndo ălĭ|ūd mĭhĭ| iām || mĭsĕr|aē nĭhĭl| īpsă rĕl|īquī),315

pēr cōn|ūbĭă| nōstră, || pĕr| īncēp|tōs hŷmĕn|aēōs,

sī bĕnĕ| quīd dē| tē || mĕrŭ|ī, fŭĭt| aūt tĭbĭ| quīcquăm

dūlcĕ mĕ|ūm, mĭsĕr|ērĕ || dŏm|ūs lāb|ēntĭs ĕt| īstăm,

ōrō|, sī quĭs ăd|hūc || prĕcĭb|ūs lŏcŭs|, ēxŭĕ| mēntĕm.

tē prōp|tēr Lĭbŷc|aē || gēn|tēs Nŏmăd|ūmquĕ tŷr|ānnī320

ōdēr|e, īnfēn|sī || Tŷrĭ|ī; tē| prōptĕr ĕ|ūndĕm

ēxstīn|ctūs pŭdŏr| ēt, || quā| sōlā| sīdĕra ăd|ībăm,

fāmă prĭ|ōr. cŭĭ| mē || mŏrĭb|ūndām| dēsĕrĭs| hōspĕs

(hōc sōl|ūm nōm|ēn || quŏnĭ|ām dē| cōniŭgĕ| rēstăt)?

quīd mŏrŏr|? ān mĕă| PŶgmălĭ|ōn || dūm| moēnĭă| frātĕr325

dēstrŭăt| aūt cāp|tām || dūc|āt Gaēt|ūlŭs Ĭ|ārbās?

sāltēm| sī quă mĭh|ī || dē| tē sūs|cēptă fŭ|īssĕt

āntĕ fŭg|ām sŭbŏl|ēs, || sī| quīs mĭhĭ| pārvŭlŭs| aūlā

lūdĕrĕt| Aēnē|ās, || quī| tē tămĕn| ōrĕ rĕf|ērrĕt,

nōn ĕquĭd|em ōmnīn|ō || cāp|ta āc dēs|ērtă vĭd|ērĕr.”330

Dīxĕrăt|. īllĕ Iŏv|īs || mŏnĭt|īs īm|mōtă tĕn|ēbăt

lūmĭna ĕt| ōbnīx|ūs || cūr|ām sūb| cōrdĕ prĕm|ēbăt.

tāndēm| paūcă rĕf|ērt: || “ĕgŏ| tē, quaē| plūrĭmă| fāndō

ēnŭmĕr|ārĕ văl|ēs, || nūm|quām, rēg|īnă, nĕg|ābō

prōmĕrĭt|ām, nēc| mē || mĕmĭn|īssĕ pĭg|ēbĭt Ĕl|īssaē335

dūm mĕmŏr| īpsĕ mĕ|ī, || dūm| spīrĭtŭs| hōs rĕgĭt| ārtūs.

prō rē| paūcă lŏ|quār. || nĕque ĕg|o hānc āb|scōndĕrĕ| fūrtō

spērāv|ī (nē| fīngĕ) || fŭg|ām, nēc| cōniŭgĭs| ūmquăm

praētēn|dī taēd|ās || aūt| haēc īn| foēdĕră| vēnī.

mē sī| fātă mĕ|īs || pătĕr|ēntūr| dūcĕrĕ| vītăm340

aūspĭcĭ|īs ēt| spōntĕ || mĕ|ā cōm|pōnĕrĕ| cūrās,

ūrbēm| Trōiān|ām || prīm|ūm dūl|cēsquĕ mĕ|ōrŭm

rēlĭquĭ|ās cŏlĕr|ēm, || Prĭăm|ī tēc|ta āltă măn|ērēnt,

ēt rĕcĭd|īvă măn|ū || pŏsŭ|īssēm| Pērgămă| vīctīs.

sēd nūn|c Ītălĭ|ām || māg|nām GrŶn|ēŭs Ăp|ōllō,345

Ītălĭ|ām Lŷcĭ|aē || iūs|sērĕ căp|ēssĕrĕ| sōrtēs;

hīc ămŏr|, haēc pătrĭ|a ēst. || sī| tē Kār|thāgĭnĭs| ārcēs

Phoēnīs|sām Lĭbŷc|aēque || ās|pēctūs| dētĭnĕt| ūrbĭs,

quaē tān|dem Aūsŏnĭ|ā || Teūc|rōs cōn|sīdĕrĕ| tērrā

īnvĭdĭ|a ēst? ēt| nōs || fās| ēxtĕră| quaērĕrĕ| rēgnă.350

mē pătrĭs| Ānchīs|aē, || quŏtĭ|ēns ūm|ēntĭbŭs| ūmbrīs

nōx ŏpĕr|īt tēr|rās, || quŏtĭ|ēns ās|tra īgnĕă| sūrgūnt,

ādmŏnĕt| īn sōm|nīs || ēt| tūrbĭdă| tērrĕt ĭm|āgō;

mē pŭĕr| Āscănĭ|ūs || căpĭt|īsque īn|iūrĭă| cārī,

quēm rēg|no Hēspĕrĭ|aē || fraūd|o ēt fāt|ālĭbŭs| ārvīs.355

nūnc ĕtĭ|am īntēr|prēs || dīv|ūm Iŏvĕ| mīssŭs ăb| īpsō

(tēstŏr ŭt|rūmquĕ căp|ūt) || cĕlĕr|ēs mān|dātă pĕr| aūrās

dētŭlĭt|: īpsĕ dĕ|ūm || mănĭf|ēsto īn| lūmĭnĕ| vīdī

īntrān|tēm mūr|ōs || vōc|ēmque hīs| aūrĭbŭs| haūsī.

dēsĭnĕ| mēquĕ tŭ|īs || īn|cēndĕrĕ| tēquĕ quĕr|ēlīs;360

Ītălĭām nōn spōntĕ sĕquōr.”

dīxĭt, ĕt| ōs īm|prēssă || tŏr|ō “mŏrĭ|ēmŭr ĭn|ūltaē,

sēd mŏrĭ|āmŭr” ă|īt. || “sīc|, sīc iŭvăt| īrĕ sŭb| ūmbrās.660

haūrĭăt| hūnc ŏcŭl|īs || īg|nēm crūd|ēlĭs ăb| āltō

Dārdănŭs|, ēt nōs|traē || sēc|ūm fĕrăt| ōmĭnă| mōrtĭs.”

dīxĕrăt|, ātque īl|lām || mĕdĭ|a īntēr| tālĭă| fērrō

cōnlāp|sam āspĭcĭ|ūnt || cŏmĭt|ēs, ēn|sēmquĕ crŭ|ōrĕ

spūmān|tēm spār|sāsquĕ || măn|ūs. īt| clāmŏr ăd| āltă665

ātrĭă|: cōncūs|sām || bāc|chātūr| Fāmă pĕr| ūrbĕm.

lāmēn|tīs gĕmĭt|ūque || ēt| fēmĭnĕ|ō ŭlŭl|ātū

tēctă frĕm|ūnt, rĕsŏn|āt || māg|nīs plān|gōrĭbŭs| aēthēr,

nōn ălĭt|ēr quām| si īmmīs|sīs || rŭăt| hōstĭbŭs| ōmnĭs

Kārthāg|o aūt ān|tīquă || Tŷr|ōs, flām|maēquĕ fŭr|ēntēs670

cūlmĭnă| pērque hŏmĭn|ūm || vōl|vāntūr| pērquĕ dĕ|ōrŭm.

aūdĭĭt| ēxănĭm|īs || trĕpĭd|ōque ēx|tērrĭtă| cūrsū

ūnguĭbŭs| ōră sŏr|ōr || foēd|āns ēt| pēctŏră| pūgnīs

pēr mĕdĭ|ōs rŭĭt|, āc || mŏrĭ|ēntēm| nōmĭnĕ| clāmăt:

“hōc īl|lūd, gēr|mānă, || fŭ|īt? mē| fraūdĕ pĕt|ēbās?675

hōc rŏgŭs| īstĕ mĭh|i, hōc || īg|nēs ār|aēquĕ păr|ābānt?

quīd prīm|ūm dēs|ērtă || quĕr|ār? cŏmĭt|ēmnĕ sŏr|ōrĕm

sprēvīs|tī mŏrĭ|ēns? || ĕăd|ēm me ād| fātă vŏc|āssēs,

īdem ām|bās fēr|rō || dŏlŏr| ātque ĕăd|em hōră tŭl|īssĕt.

hīs ĕtĭ|ām strūx|ī || mănĭb|ūs pătrĭ|ōsquĕ vŏc|āvī680

vōcĕ dĕ|ōs, sīc| te ūt || pŏsĭt|ā, crūd|ēlĭs, ăb|ēssĕm?

ēxstīn|xtī tē| mēquĕ, || sŏr|ōr, pŏpŭl|ūmquĕ păt|rēsquĕ

Sīdŏnĭ|ōs ūr|bēmquĕ || tŭ|ām. dătĕ|, vūlnĕră| lŶmphīs

āblŭam ĕt|, ēxtrēm|ūs || sī| quīs sŭpĕr| hālĭtŭs| ērrăt,

ōrĕ lĕg|ām.” sīc| fātă || grăd|ūs ēv|āsĕrăt| āltōs,685

sēmiănĭm|ēmquĕ sĭn|ū || gēr|mānam ām|plēxă fŏv|ēbăt

cūm gĕmĭt|u ātque āt|rōs || sīc|cābāt| vēstĕ crŭ|ōrēs.

īllă grăv|ēs ŏcŭl|ōs || cōn|āta āt|tōllĕrĕ| rūrsŭs

dēfĭcĭt|; īnfīx|ūm || strīd|īt sūb| pēctŏrĕ| vūlnŭs.

tēr sēs|e āttōl|lēns || cŭbĭt|ōque ād|nīxă lĕv|āvĭt,690

tēr rĕvŏl|ūtă tŏr|o ēst || ŏcŭl|īsque ēr|rāntĭbŭs| āltō

quaēsīv|īt caēl|ō || lūc|em īngĕmŭ|ītquĕ rĕp|ērtā.

Tūm Iūn|o ōmnĭpŏt|ēns || lōn|gūm mĭsĕr|ātă dŏl|ōrĕm

dīffĭcĭl|ēsque ŏbĭt|ūs || Īr|īm dēm|īsĭt Ŏl|Ŷmpō

quaē lūc|tāntem ănĭm|ām || nēx|ōsquĕ rĕs|ōlvĕrĕt| ārtūs.695

nām quĭă| nēc fāt|ō || mĕrĭt|ā nēc| mōrtĕ pĕr|ībăt,

sēd mĭsĕr|a āntĕ dĭ|ēm || sŭbĭt|ōque āc|cēnsă fŭr|ōrĕ,

nōndum īl|lī flāv|ūm || Prōs|ērpĭnă| vērtĭcĕ| crīnĕm

ābstŭlĕr|āt Stŷgĭ|ōquĕ || căp|ūt dām|nāvĕrăt| Ōrcō.

ērgo Īr|īs crŏcĕ|īs || pēr| caēlūm| rōscĭdă| pēnnīs700

mīllĕ trăh|ēns vărĭ|ōs || ād|vērsō| sōlĕ cŏl|ōrēs

dēvŏlăt| ēt sūp|rā || căpŭt| āstĭtĭt|. “hūnc ĕgŏ| Dītī

sācrūm| iūssă fĕr|ō || tē|que īstō| cōrpŏrĕ| sōlvō”:

sīc ăĭt| ēt dēx|trā || crīn|ēm sĕcăt|, ōmnĭs ĕt| ūnā

dīlāp|sūs călŏr| ātque || īn| vēntōs| vītă rĕc|ēssĭt.705